156,156,156,156,156,156,156,156,156,156,156,156,156,156,156,156,156,156,156,156,156
156,156,156,156,156,156,156,156,156,156,156,156,156,156,156,156,156,156,156,156,156
156,156,156,156,156,156,156,156,156,156,156,156,156,156,156,156,156,156,156,156,156
156,156,156,156,208,209,210,183,183,183,210,210,210,210,210,175,156,156,156,156,156
156,156,156,156,224,225,226,199,199,199,203,203,203,203,203,191,156,156,156,156,156
156,156,156,156,240,241,242,215,215,215,159,159,159,159,159,207,156,156,156,156,156
156,156,156,156,200,179,180,153,153,153,153,153,153,153,153,223,156,156,156,156,156
156,156,156,156,19,195,196,153,153,153,153,204,205,153,153,239,156,156,156,156,156
156,156,156,156,236,211,212,153,153,153,153,220,221,153,153,220,156,156,156,156,156
156,156,156,156,200,153,153,153,153,153,153,190,237,153,153,190,156,156,156,156,156
156,156,156,156,216,153,153,181,182,153,153,252,252,153,153,206,156,156,156,156,156
156,156,156,156,232,253,253,197,198,253,253,253,253,253,253,222,156,156,156,156,156
156,156,156,156,156,156,156,156,156,156,156,156,156,156,156,156,156,156,156,156,156
156,156,156,156,156,156,156,156,156,156,156,156,156,156,156,156,156,156,156,156,156
156,156,156,156,156,156,156,156,156,156,156,156,156,156,156,156,156,156,156,156,156
156,156,156,156,156,156,156,156,156,156,156,156,156,156,156,156,156,156,156,156,156
